2 0 0 1 1 1 1 1 1 1
0 110 0 1 1 1 1 70021 1 1
0 0 0 50031 1 1 1 1 1 1
100031 1 1 1 1 1 1 1 1 1
1 1 1 1 1 1 20021 1 1 1
1 1 1 1 311 1 1 1 1 1
1 80031 1 1 1 411 1 1 1 1
1 1 1 1 1 1 1 1 1 1
1 1 1 1 1 1 211 1 40021 1
1 1 1 1 1 1 1 1 1 1